                             I                                                  
                                                                                
                                                                                
                 ##                          ##                                 
                ####                        ####                                
                ####         ####           ####                                
                 ##           ##             ##                                 
                 ##-----------##-------------##                                 
                 ##         $ ## $           ##       ###                       
                 ##-----------##-------------############                       
                 ## $         ##           $ ##       ###                       
                 ##-----------##--------#######        @                        
                 ##                          ##        @                        
                 ##         "#####           ##        @                        
                 ##                                    @                        
                 ##                                    @       e                
                 ##                          #####~##############               
                 ##                         ###                                 
                 ##                        ####                                 
                 ##                       #####                                 
                 ##                      ######                                 
                ####         ####T      ########                                
                ####                        ####                                
                 ##                          ##                                 
                                                                                
